[MAIN MENU]
Training=Training
SingleMission=Einzelspielermission
Campaign=Kampagne
UnitReference=Einheitenverzeichnis
Options=Optionen
Credits=Credits
Quit=Beenden

[GENERAL]
Back=Zurück
Start=Start
Accept=Ok
Random=Zufällig
Help=Hilfe
Load=Laden
Save=Speichern
Delete=Löschen
No=NEIN
Yes=JA
Labels=Bezeichnung
Menu=Menü
Hours=Stunden

[BRIEFINGS]
InTheVicinityOf=In der Nähe von
DockedAtPort=Angedockt an <PLAYERPORT>
StoresStatus=VOLL BESTÜCKT
StoresStatusNeg=AUFMUNITIONIERUNG VERFÜGBAR
SystemsStatus=ALLE SYSTEME FUNKTIONSTÜCHTIG
SystemsStatusNeg=REPARATUREN BENÖTIGT
LeaveCombatNeg=NEIN
LeaveCombatMissionNeg=NICHT
LeaveCombatVessels=SCHIFFE NAHE
LeaveCombatWeapons=WAFFEN NAHE
LeaveCombatAircraft=FLUGZEUG NAHE
LeaveCombatFlooding=FLUTUNG
LeaveCombatInsertion=KOMMANDOTRUPP <MISSIONSTATUS> ABGESETZT
LeaveCombatLandStrike=FESTLANDBESCHUSS <MISSIONSTATUS> ABGESCHLOSSEN <LANDSTRIKESTATUS>
NearDeploymentZone=Missionseinsatzzone ist nahe.

//MissionWeaponsNeg=Benötige <NUMBER> <WEAPON> an Bord für die aktuelle Mission.
//CommandoNeg=Benötigt ein SEAL-Team an Bord für aktuelle Mission.
RepairTime=Reparaturzeit
Minutes=Min
Hours=Stunden

[HEADINGS]
TrainingMissionHeader=TRAINING
SingleMissionHeader=EINZELSPIELERMISSION
UnitReferenceHeader=EINHEITENVERZEICHNIS
SelectVesselHeader=WÄHLE SCHIFF
BriefingHeader=BESPRECHUNG
OrdersHeader=BEFEHLE
NewCampaignHeader=NEUE KAMPAGNE
LoadCampaignHeader=LADE KAMPAGNE
OptionsHeader=OPTIONEN
IncomingMessageHeader=EMPFANGE NACHRICHT

[COMMANDS]
Battlestations=Alle Mann auf Gefechtstation
AttemptClosure=Nahe bei:
ContinueCourse=Weiter auf Kurs
Loadout=Waffenbestückung
DamageControl=Schadenskontrolle
VesselStatus=XO: Statusbericht
RearmRepair=Nachladen und Reparieren
ReviewOrders=Überprüfe Befehle
AbandonShip=Schiff aufgeben
LeavePort=Anker lichten, Leinen los!
HoursInPort=Stunden im Hafen:
ExitMission=Verlasse Gefecht
QuitMission=Beende Mission

[HUD]
ConditionsTab=BEDINGUNGEN
SignatureTab=SIGNATUREN
StoresTab=VORRÄTE
DamageControlTab=SCHADENSKONTROLLE
Course=KURS
Speed=SPD
Depth=DEP
Rudder=RUD
Planes=PLN
Ballast=BAL
Bearing=BRG
Knot=KT
Feet=FT
Metre=M
Range=RNG
KiloYard=KYD
Kilometer=KM
Solution=SOL
Percentage=%
WeaponData=WPN DATA
RangeToEnable=RTE
TimeToRun=TTR
AmbientNoise=UMGEBUNGSGERÄUSCH
Decibels=dB
SurfaceDuct=DRUCK
Layer=SCHICHT
Floor=GRUND BEI
Contact=KONTAKT
Offline=OFFLINE
SignalStrength=SIG STR
OwnShip=OWNSHIP
SensorComparison=SNS COMP
Profile=PROFIL:
DepthGauge=0\n100\n200\n300\n400\n500\n600\n700\n800\n900\n1000
LoadWeapon=LADEN
UnloadWeapon=ENTLADEN
LoadCommando=LADE KOMMANDOTRUPP
UnloadCommando=ENTLADE KOMMANDOTRUPP
NoisemakerStores=Lärmgenerator
NoContact=KEIN KONTAKT
VerticalLaunchSystem=Senkrechtstartanlage für Flugkörper:
VerticalLaunchSystemAbb=VLS
HullStatus=Hülle:

[ACTION REPORT]
ActionReportSunk=VERSENKT
ActionReportDamaged=BESCHÄDIGT
ActionReportEscaped=ENTKOMMEN
ActionReportUndetected=UNENTDECKT
ActionReportNone=KEIN
ActionReportLost=VERLOREN
ActionReportLostAllHands=VERLOREN MIT GESAMTER BESATZUNG

[CAMPAIGN]
SaveFileName=Speichere Dateinamen:
CommanderName=Kommandantenname:
DeleteSaveFile=Diesen Speicherstand löschen?: <FILENAME>?
SaveExists=Speicherstand existiert bereits. Überschreiben?
Statistics=Zusammenfassung
OpenBriefing=Einweisung

[UNIT REFERENCE]
ReferenceDimensions=Dimensionen
ReferenceTons=t
ReferenceMetre=m
ReferenceKnot=kn
ReferenceFeet=ft
ReferenceCrew=Crew
ReferenceDefensive=Defensivwaffen
Reference30mmCIWS=30mm CIWS-Geschütze
ReferenceNone=Keine
ReferenceOffensive=Offensivwaffen
ReferenceMissiles=Raketen
ReferenceDecoys=Köder
ReferenceTorpedoes=Torpedos
ReferenceSensors=Sensoren
ReferenceNavRADAR=Nur Navigationsradar
ReferenceSearchRADAR=Suchradar, EloUM
ReferenceMastMounted=mastmontiert
ReferenceSonarBoth=aktives and passives Sonar
ReferenceSonarActive=aktives Sonar
ReferenceSonarPassive=passives Sonar
ReferenceSonar=Sonar
ReferenceRadar=Radar
ReferenceActive=Active
ReferencePassive=Passive
ReferenceTowed=Geschleppt
ReferenceHullMounted=hüllenmontiert
ReferenceTowedArray=Schleppsonar
ReferenceDipping=eintauchend
ReferenceSonobuoy=Sonarboje
ReferenceAircraft=Flugzeug
ReferenceNotes=Notizen
ReferenceKilogram=kg
ReferenceYard=yd
ReferenceRange=Reichweite
ReferenceMaxSpeed=Max. Geschwindigkeit
ReferenceSeekerRange=Erfassungsreichweite
ReferenceAt=bei
FrequencyVeryLow=sehr niedrig
FrequencyLow=niedrig
FrequencyMedium=mittel
FrequencyHigh=hhoch
Frequency=Frequenz
Frequencies=Frequenzen
ReferenceVeryQuiet=Sehr Ruhig
ReferenceSemiQuiet=Halbwegs Ruhig
ReferenceQuiet=Ruhig
ReferenceSemiNoisy=Halbwegs Laut
ReferenceNoisy=Laut
ReferenceVeryNoisy=Sehr Laut
FrequencyAbbreviated=F

[Sea States]
Calm=Ruhig
LightAir=Leiser Zug
LightBreeze=Leichte Brise
GentleBreeze=Schwache Brise
ModerateBreeze=Mäßige Brise
FreshBreeze=Frische Brise
StrongBreeze=Starker Wind
HighWind=Stürmischer Wind

[Weather]
Clear=Klar
Scattered=Leicht bewölkt
Broken=Wolkig
Overcast=Bedeckt
Rain=Regen
Storm=Sturm
Snow=Schnee
SnowStorm=Schneesturm

[Strength Types]
ZeroStrength=Kein
VeryWeak=Sehr schwach
Weak=Schwach
Moderate=Moderat
Strong=Stark
VeryStrong=Sehr Stark

[ERROR]
FatalError=FATALER FEHLER:

[OPTIONS]
GameSettings=Spiel
Controls=Tastaturbelegung
VideoSettings=Video
AudioSettings=Audio
DefaultControls=Standardeinstellungen wiederherstellen
DefaultCommanderName=Standard Kommandantenname:
Difficulty=Schwierigkeitsgrad
Easy=Einfach
Normal=Normal
Hard=Realistisch
Elite=Elite
WorldScale=Distanzmaßstab
Scale1=1:1
Scale2=1:2
Scale3=1:3
Scale4=1:4
SpeedMultiplier=Geschwindigkeitsmultiplikator
HideUnclassified=Verstecke schwache SOL. Kontakte in 3D

HUDSize=HUD Größe
AutoSave=Automatisch Speichern
DisableIronman=Deaktiviere Ironman
PlayerMarker=Spielermarkierung
NonMetricUnits=Non-Metrische Einheiten
EventCamera=Ereigniskamera
InvertMouse=Invertiere Maus
FullScreen=Vollbildschirm
Resolution=Auflösung
Shadows=Schatten
VSync=V-Sync
DetailedOcean=Detaillierter Ozean
Terrain=Terrain
Trees=Bäume
UnderwaterParticles=Unterwasserpartikel
AntiAliasing=Anti-Aliasing
Off=Aus
2x=2x
4x=4x
8x=8x
OceanQuality=Ozeanqualität
High=Hoch
Medium=Mittel
Low=Niedrig
ColorFilter=Farbfilter
AmbientOcclusion=Ambient Occlusion
Bloom=Bloom
WorldObjects=Display World Objects
MusicInCombat=Musik im Gefecht
Volume=Lautstärke
Music=Musik
CameraSensitivity=Kameraempfindlichkeit
Apply=Übernehmen

[HELP]
HelpGeneral=Allgemein
HelpReference=Referenz
HelpWeapons=Waffen
HelpNavigation=Navigation
HelpMap=Karte
HelpSensors=Sensoren
HelpTactics=Taktik
HelpDamage=Schaden
HelpCampaign=Kampagne
LeftMouse=LINKSKLICK
RightMouse=RECHTSKLICK
MiddleMouse=MITTLERE MAUSTASTE
MouseWheel=MAUSRAD
ShiftKey=Shift
ControlKey=STRG
AltKey=Alt


[KEYBIND DISPLAY NAMES: COMMAND=OPTIONS DISPLAYNAME]
Help=Hilfe

Rudder Left=Ruder Links
Rudder Right=Ruder Rechts
Planes Up=Tiefenruder Auf
Planes Down=Tiefenruder Ab
Ballast Up=Ballast Auf
Ballast Down=Ballast Ab
Increase Power=Leistung Erhöhen
Decrease Power=Leistung Senken

Level Submarine=Gerade & Gleichbleibend
Blow Ballast=Ballast ausblasen
Sonar Mode=Aktivsonar
Silent Running=Schleichfahrt
Noisemaker=Lärminstrument

ESM Mast=ESM-Mast
RADAR Mast=Radarmast
Periscope=Periskop
Periscope View=Periskopansicht
Night Vision=Nachtsicht
Mark Target=Ziel Markieren

Tactical Map=Taktische Karte
Centre Map=Karte zentrieren
Auto Centre Map=Karte automatisch zentrieren

Conditions=Konditionen
Signature=Signaturen
Damage Report=Schadensbericht
Context Menu Previous=Kontextmenü vorherig
Context Menu Next=Kontextmenü Nächstes
Context Menu Set=Kontextmenü Festgelegt
Next Contact=Nächster Kontakt

Next Tube=Nächstes Rohr
Load Tube=Lade Rohr
Stores=Vorräte
Fire Tube=Rohr abschießen
Set Waypoint=Setze Wegpunkt
Edit Waypoint=Editiere Wegpunkt

Weapon Homing=Waffensensor
Weapon Attack=Waffensuche
Weapon Depth=Waffentiefe
Activate Torpedo=Aktiviere Torpedo
Cut Wire=Draht Kappen
Steer Torpedo Left=Steuere Torpedo Links
Steer Torpedo Right=Steuere Torpedo Rechts
Steer Torpedo Shallow=Steuere Torpedo Flach
Steer Torpedo Deep=Steer Torpedo Tief

Time Compression=Zeitkompression
Hide HUD=Verberge HUD
Event Camera=Eventkamera An/Aus

Zoom In=Hereinzoomen
Zoom Out=Herauszoomen

Camera Left=Kamera Links
Camera Right=Kamera Rechts
Camera Up=Kamera Auf
Camera Down=Kamera Ab
Camera To Player=Kamera zum Spieler
Camera To Selected Contact=Kamera zum gewählten Kontakt
Camera To Weapon=Kamera zur Waffe
Camera To Aircraft=Kamera zum Flugzeug
Camera To Scenery=Kamera zur Szenerie
Drag Camera=Ziehe Kamera
Still Camera=Stop Kamera

Patrol Speed=Patrouillengeschwindigkeit
Flank Speed=Höchstgschwindigkeit
Briefing=Besprechung

Museum Next=Museum Vor
Museum Previous=Museum Zurück

Continue=Weiter
Cancel or Quit=Abbrechen oder Beenden
